医心医意海燕的主页 - 承德医学院附属医院妇产科主治医师 王海艳 - 抖音
医路向前巍子的主页 - 北京大学第一医院密云医院急诊外科医师 - 抖音
中医谭医生的主页 - 湘潭市中心医院针灸科副主任医师 谭灿灿 - 抖音
中医内科吴金荣主任的主页 - 北京中医药大学东直门医院内科主任医师 - 抖音
中医黎明的主页 - 山西省中医院中医科主任医师 - 抖音
湘雅肖岚的主页 - 中南大学湘雅三医院中医科副主任医师 肖岚 - 抖音
{}
妇科郑晨思博士的主页 - 深圳市妇幼保健院生殖中心主治医师 郑晨思 - 抖音
妇科孙娟博士的主页 - 广东省中医院妇科副主任医师 孙娟 - 抖音
生殖妇科刘海英的主页 - 广州医科大学附属第三医院生殖医学中心主任医师 刘海英 - 抖音
太原市生殖科郭晶晶医生的主页 - 太原市中心医院生殖中心主治医师 郭晶晶 - 抖音
曹艳医生的主页 - 利川市民族中医院妇产科主治医师 曹艳 - 抖音
乳腺科屹姐的主页 - 盛京医院外科主治医师 魏宏屹 - 抖音
恩哥聊健康的主页 - 复旦大学附属妇产科医院 妇科主任医师 邹世恩 - 抖音
生殖科博士蔡学泳的主页 - 深圳市第二人民医院生殖医学科副主任医师 蔡学泳 - 抖音
安徽省立贾素梅主任的主页 - 安徽省立医院妇产科主任医师 贾素梅 - 抖音
皮肤科副主任-顿艳波的主页 - 深圳市宝安区中医院皮肤科副主任医师 顿艳波 - 抖音
妇产科王杨的主页 - 上海中医药大学附属曙光医院生殖中心主治医师 王杨 - 抖音
妇产科朱洪磊的主页 - 珠江医院妇产医学中心副主任医师 朱洪磊 - 抖音
妇科主任医师周坚红的主页 - 浙江大学医学院附属妇产科医院妇产科主任医师 周坚红 - 抖音
妇产科汤主任的主页 - 广州市妇女儿童医疗中心产科主任医师 汤栩文 - 抖音
妇产科黄海霞的主页 - 重庆市公共卫生医疗救治中心妇产科副主任医师 黄海霞 - 抖音
畅说遇闫的主页 - 上海市第一人民医院妇产科主治医师 闫忠鑫 - 抖音
妇科董哥的主页 - 山东省中西医结合医院妇产科主治医师 董焱 - 抖音
省妇幼董医生的主页 - 山东省妇幼保健院妇产科主治医师 董玉燕 - 抖音
刘梨说健康的主页 - 湖南中医药大学附一院针灸推拿科室副主任 刘梨 - 抖音
妇科医生孙斌的主页 - 广州医科大学附属第三医院妇产科主治医师 孙斌 - 抖音
心中有术的主页 - 北京安贞医院心外科主治医师 白辰 - 抖音
中医妇科专家王晓锋的主页 - 北京市第一中西医结合医院中医科副主任医师 王晓锋 - 抖音
妇科杨青梅教授的主页 - 成都市第一人民医院妇产科主任医师 杨青梅 - 抖音
妇产科崔雪梅的主页 - 郑州市中心医院妇产科主任医师 崔雪梅 - 抖音
妇产科雷华江的主页 - 四川省妇幼保健协会妇科分会委员 雷华江 - 抖音
妇产科范海燕的主页 - 山东中医药大学第二附属医院妇产科主治医师 范海燕 - 抖音
皮肤科副主任李茜的主页 - 广州市番禺区中医院皮肤科副主任医师 李茜 - 抖音
江西生殖专家聂玲的主页 - 江西省妇幼保健院生殖中心主治医师 聂玲 - 抖音
妇产科张主任的主页 - 广州医科大学附属第三医院妇产科主任医师 张中芳 - 抖音
妇科医生赵艳忠的主页 - 北京医学会运动医学分会委员 赵艳忠 - 抖音
妇产科黄谧娇医生的主页 - 广州市暨南大学附属第一医院妇产科主治医师 黄谧娇 - 抖音
妇产科梁培琴医生的主页 - 南方医科大学第三附属医院妇产科主治医师 梁培琴 - 抖音
妇产科牛诤医生的主页 - 杭州市第一人民医院妇产科副主任医师 牛诤 - 抖音
妇产科任主任的主页 - 上海曙光医院生殖中心副主任医师 任春霞 - 抖音
中医妇科专家陈莹的主页 - 辽宁中医药大学附属医院中医妇科主任医师 陈莹 - 抖音
苏州生殖科李雪医生的主页 - 苏州大学附属第二医院生殖科副主任医师 李雪 - 抖音
妇产科何医生的主页 - 广州医科大学附属第一医院妇产科主任医师 何志晖 - 抖音
👩🏻‍⚕️妇产科陈姐👩🏻‍⚕️的主页 - 北京朝阳医院妇产科主任医师 陈晨 - 抖音
女性健康乔的主页 - 上海市第一人民医院妇产科主治医师 乔敏 - 抖音
妇产科张秀英的主页 - 安徽省立医院妇产科主任医师 张秀英 - 抖音
好孕医生杜宁宁的主页 - 亳州市人民医院生殖医学科主任医师 杜宁宁 - 抖音
辛主任说健康的主页 - 北京妇产医院中医科主任医师 辛明蔚 - 抖音
妇科医生徐丽清的主页 - 广东省妇幼保健院生殖中心主治医师 徐丽清 - 抖音
广州南方医院王瑾的主页 - 南方医科大学南方医院整形美容外科主治医师 王瑾 - 抖音
整形医生娄艳红的主页 - 中国中西医结合学会医学美容专业委员会青年委员 娄艳红 - 抖音
不正经学姐的主页 - 抖音
曾老师揭秘营养的主页 - 注册营养师 - 抖音
皮肤科周冼苡主任的主页 - 南方医科大学第三附属医院皮肤科主任医师 周冼苡 - 抖音
庞教授说姨妈的主页 - 广州中医药大学第一附属医院妇科主任医师 庞震苗 - 抖音
妇产科-许啸声的主页 - 上海瑞金医院妇产科副主任医师 许啸声 - 抖音
妇产科李主任的主页 - 南医三院妇产科副主任医师 李迎春 - 抖音
中医谭医生的主页 - 湘潭市中心医院针灸科副主任医师 谭灿灿 - 抖音
孙主任备孕说的主页 - 昆明医科大学第一附属医院妇科副主任医师 孙启建 - 抖音
妇产科舒大夫的主页 - 南方医科大学第三附属医院妇产科副主任医师 舒从爱 - 抖音
妇瘤科王莉英教授的主页 - 河南省肿瘤医院妇科主任医师 王莉英 - 抖音
医心医意海燕的主页 - 承德医学院附属医院妇产科主治医师 王海艳 - 抖音
妇产科秀兰主任的主页 - 广东省妇幼保健院生殖健康与不孕症副主任医师 朱秀兰 - 抖音
肿瘤科芦殿荣教授的主页 - 望京医院肿瘤科主任医师 芦殿荣 - 抖音
产科王亚琴医生的主页 - 陕西省人民医院产科主任医师 王亚琴 - 抖音
妇产科李晓丽的主页 - 甘肃省妇幼保健院妇产科主治医师 李晓丽 - 抖音
👨‍⚕️老吴👨‍⚕️的主页 - 健康知识创作者 - 抖音
妇产科博士张瑾的主页 - 首医附属北京世纪坛医院妇产科副主任医师 张瑾 - 抖音
妇科花姐的主页 - 武汉市中心医院妇科副主任医师 付月玲 - 抖音
妇产医生李凤梅的主页 - 郑州市中心医院妇产科副主任医师 李凤梅 - 抖音
生殖科王克芳医生的主页 - 北京安贞医院妇产科主任医师 王克芳 - 抖音
苏州生殖科高医生的主页 - 苏州大学附属第二医院生殖科主任医师 高爱华 - 抖音
中医妇科贡欣博士的主页 - 中华中医药学会妇科分会第五届委员会青年委员 贡欣 - 抖音
妇产科女超人张医生的主页 - 南方医科大学珠江医院 妇产科主治医师 张晓玉 - 抖音
妇产科杨苏安的主页 - 长沙市第一医院妇产科主任医师 杨苏安 - 抖音
妇科专家贺主任的主页 - 上海市第一妇婴保健院妇科主任医师 贺银燕 - 抖音
妇产科童主任的主页 - 西安交通大学第一附属医院生殖医学科主任医师  - 抖音
中医吴大夫的主页 - 山东大学第二医院中医科主治医师 吴研 - 抖音
妇产科刘义的主页 - 武汉协和医院生殖医学中心科室副主任 刘义 - 抖音
史晓光主任的主页 - 东直门医院乳腺科主任医师 史晓光 - 抖音
妇产科李洪钧的主页 - 南医三院妇产科主任医师 李洪钧 - 抖音
护花使者程主任🌸的主页 - 上海市东方医院妇产科主任医师 程静新 - 抖音
妇产科陈大夫的主页 - 中山大学孙逸仙纪念医院妇产科主治医师 陈亚肖 - 抖音
李姐聊生殖的主页 - 山东中医药大学第二附属医院生殖医学科主治医师 李艳 - 抖音
皮肤科教授张堂德的主页 - 南方医科大学珠江医院皮肤科主任医师 张堂德 - 抖音
八大处整形医生杨庆华的主页 - 中国医学科学院整形外科医院整形外科主任医师 杨庆华 - 抖音
{'畅说遇闺': '畅说遇闫', '旁教授说姨妈': '庞教授说姨妈', '妇产科李洪均': '妇产科李洪钧', '护花使者程主任': '护花使者程主任🌸'}
陈博士科普的主页 - 湖南中医药大学附属第二医院肾病科主治医师 陈志成 - 抖音
张强医生的主页 - 中国医科大学附属盛京医院呼吸科副主任医师 张强 - 抖音
{}
中医黎明的主页 - 山西省中医院中医科主任医师 - 抖音
{}
